.....3......
.0.X........
.....33..3..
............
3.3.##.3....
........XXX.
.....3.##X##
...X...#G...
......3###..
.3...X......
..XXX.....##
............
